R 1920 1080
NO ./assets/textures/wood.xpm
SO ./assets/textures/bluestone.xpm
WE ./assets/textures/colorstone.xpm
EA ./assets/textures/redbrick.xpm
S ./assets/textures/wood.xpm
F 220,100,0
C 221,30,0

                                                  
                                                  
                             111                  
                            10001                 
                           1000001  111           
                    11     100001 110001          
                 111001    10001 1000101          
                100000011111000011000001          
                10000000000000000000011           
         1111 1 100101101000010000101             
    1  110000101 1110110000000000001              
   1011000000000111101000000000110001             
  1100000000111100000000000000011011              
 1000000000001110010001000100001001               
 11000000100000001 101 11010000001                
10000001110000101   1   100100111                 
1000000011001011    1111000000001                 
101000001 10001    10000000000001                 
100000001  101     10011000000001                 
10000001   101   11101  100000001                 
10000011   101 11000011  1111111                  
10000001    111000000001111                       
1000000111  1000000010000001                      
10000000001 1000000010000101                      
1010000100011000001000000001                      
1000001 11001000000000000001                      
 110001  100110000S000101001                      
  110001 101110000000000111                       
 1000000110100000000000011                        
 10011000101000000000000001                       
 10000000100011100000001001                       
1000000001111  100000000001                       
1001110001      100000000011                      
101  10101       100000000001                     
 1   10101       100000001101                     
     10001      110000001 10011                   
      1101     1000000001 100001                  
       101     100000001  100001                  
        1      10000001111100001                  
               1100000000000011                   
              1000000000000001                    
             10000000000111101                    
             100000000011   1                     
              110000000001                        
               10000000001                        
                110001001                         
                  100101                          
                  100001                          
                   11001                          
                     11                           
