R 1000 1000
NO ./assets/textures/wood.xpm
SO ./assets/textures/bluestone.xpm
WE ./assets/textures/colorstone.xpm
EA ./assets/textures/redbrick.xpm
S ./assets/textures/wood.xpm
F 220,100,0
C 221,30,0

11111
10001
10N01
10001
11111
