R 800 800
NO ./assets/textures/wood.xpm
SO ./assets/textures/bluestone.xpm
WE ./assets/textures/colorstone.xpm
EA ./assets/textures/redbrick.xpm
S ./assets/textures/wood.xpm
F 220,100,0
C 225,30,0

111111
100101
102W01
110001
111111