R 800 800
NO ./assets/textures/wood.xpm
SO ./assets/textures/bluestone.xpm
WE ./assets/textures/colorstone.xpm
EA ./assets/textures/redbrick.xpm
S ./assets/textures/wood.xpm
F 220,100,0
C 225,30,0

         1111   111 
        100001 10001
       1000001 10021
      11100101100001
     100000001000001
     100000000000001
    100000000000011 
    10000200000001  
     100000101011   
     10000100001    
      10010010001   
    11020100111011  
   1020111001 10001 
  1101100001   11021
 10001000001     101
 101202000001    101
  1 1100100001   1E1
      1000001    101
      101111      1 
       1            
