R 800 800
NO ./assets/textures/wood.xpm
SO ./assets/textures/bluestone.xpm
WE ./assets/textures/colorstone.xpm
EA ./assets/textures/redbrick.xpm
S ./assets/textures/wood.xpm
F 255, 255, 255
C 0, 0, 0

                         1111111 111111111111     
                        1000000010000000000001    
                        10000000000000000000001   
                         1111000000000000000001   
                           10000000000000000001   
                           10000000000000000001   
                           100000000000000000011  
                           1000000000000000000101 
                          10000000000100000000001 
                         1 10100000001000000000001
                        10110000000001000000000001
                        10000100000000011000000001
                        1000010000000001 100000001
                         1100000000000001001000001
                         1110000000000100000000001
                        10000000000000000000000001
                        10000000000000110001100001
                        100000000110001 1011 10001
                         10000011  111 100001 101 
                         100001        10001  101 
                        1000001         101    1  
                         110001         1001      
                           1001          1001     
                            11            101     
                                          1001    
                                          10001   
                                        110001    
                                       100011     
                                       1001       
                                       10111      
                                       100001     
                                       100001     
                                       100001     
                           11           1011      
                          1001          10011  1  
                          10001         100001101 
                          100N1          110000001
                          1001            10000001
                          10011           10000001
                          100001       11100000001
                           11101      100101000001
                             1001   11100100000001
                             101011100000000000001
                            1001000100011110001101
                            100000010001   1111001
                            10000000011        101
                            1000000001          1 
                            100001111             
                            100001                
                             1111                 
